NO ./path_to_the_north_texture
SO ./path_to_the_south_texture
WE ./path_to_the_west_texture
EA ./path_to_the_east_texture
F 220,100,0
C 225,30,0
  111111 111
 1100001 101
111000011101
  1000000001
111000111101111111111111
1000001  100000000000001
101110111101000000000001
101 10000001111111111111
111 1111111


HOLA
Que
Tal'??!!
